000000010000000
000000000000000
000000000000000
111100000000000
000100010000000
000000010000000
000000010000000
000000010000000
000000010011000
001000010000111
001000010000000
001000010000000
000000000000000
000000000111111
000000000000000
000010000000000
000001000000000
000000100000000
000000010000000
000000000000000
